1111111111111111111111111
10E01000000000000000 0001
11100000000000000000 0001
10000000000000000000 0001
10000P00000000000000 0001
10000000000000000000 0001
1000000000000 000000 1111
10000000000000000000 0C01
1111111111111111111111111
