1111111111111111111
1000010000000001111
1011011111000001111
11E0000000000P01111
1011000000001001111
100011111011000CCC1
1111111111111111111
